NO xpm/wall.xpm
SO xpm/wall.xpm
WE xpm/wall-dark.xpm
EA xpm/wall-dark.xpm

F 220,100,42
C 225,30,42


   111111111111111111111111111111
111100000000000000110000000000001
300100000000000001110000000000001
100000000011000000000000000000001
100000000011000001110000000000001
100000000011000001110111111111011
111101111111110111000000000010001
111101111111110100010101010010001
110000001101010100000000000010001
100000000000000000000000010010001
100000000000000000010110000010001
110000011101010111110111010010N01
11110111 1010101 3000001000010111
11111111 1112111 11111111111111
