NO xpm/big-grid-cyan.xpm
SO xpm/big-grid-cyan.xpm
WE xpm/big-grid-cyan.xpm
EA xpm/big-grid-cyan.xpm

F 220,100,0
C 225,30,0


   111111111111111111111111111111
111100000000000000110000000000001
100000000011000001110000000000001
100100000011000000000000000000001
100100000011000001110000000000001
100000000011000001110111110111111
11110111111111011100000010001
11110111111111010001010010001
11000000110101010000000010001
10000000000000000000000010001
10000000000000000001010010001
11000001110101011111011110N0111
11110111 1110101 101111010001
11111111 1111111 111111111111
